20
11
BVVVVVVVVVVVVVVVVVOB
H                  H				
H   B     B        H
H   H     H     HBBH
H   B     B     H  H
H  BHHHHHHHB  BHB  H
H          HB   H SH
H  BHHHHB  H    H  H
H  H    H  HB HHB BH
H EB    H  H       H
BHHHHHHHBCHBHHHHHHHB